########%
########%
######&#%
@@@@###%%
#@%%%%%%%